20
20
####################
#.................##
#.................##
#.................##
#...###########...##
#...###########...##
#...###########...##
#...###########...##
#...###########...##
#...###########...##
#...###########...##
#...###########...##
#...###########...##
#...###########...##
#...###########...##
#...###########...##
#.................##
#.................##
#.................##
####################